111111111111111
100000000000001
101101111101101
101000000000101
101011101110101
101010000010101
101010101010101
100000000000001
101010101010101
101010000010101
101011101110101
101000000000101
101101111101101
100000000000001
111111111111111