999999999999999
900000000000009
901101111101109
901000000000109
901011111110109
901010000010109
901010101010109
900010000010009
901010101010109
901010000010109
901011111110109
901000000000109
901101111101109
900000000000009
999999999999999
